List of words and word types to add to molli's "database"

Luokka:	Ilmansuunnat
Pohjoinen	Itä	Etelä	Länsi
Север	восток	юг	запад

Luokka:	Ajanmääreet
Maanantai	Tiistai	Keskiviikko	Torstai	Perjantai	Lauantai
Понедельник	Вторник	Среда	Четверг	Пятница	Суббота

Tammikuu	helmikuu	maaliskuu	huhtikuu	toukokuu	kesäkuu
Январь	Февраль	Март	Апрель	Май	Июнь

heinäkuu	elokuu	syyskuu	lokakuu	marraskuu	joulukuu
Июль	Август	Сентябрь	Октябрь	Ноябрь	Декабрь

Eilen Nyt Tänään  Huomenna
      сейчас      завтра

Luokka:	Lukusanat
Yksi	Kaksi	Kolme	Neljä	viisi
Один	два	три	четыре	пять

Kuusi	Seitsemän	Kahdeksan	Yhdeksän	Kymmenen
шесть	семь	восемь	девять	десять

Luokka: Pronomineja
Tämä tuo tässä tuossa

Luokka: Kysymyssanoja
Mikä  Kuka  Missä Milloin Miksi

Worddive-sanoja
одъезд - Lähtö
- Lämmin
холодный - Kylmä
конец - Loppu
улицы - Katu
спасибо - Kiitos
сын - Poika
рядом - Lähellä
